R 800 600

NO ./textures/path_to_the_north_texture.xpm
SO ./textures/path_to_the_south_texture.xpm
WE ./textures/path_to_the_west_texture.xpm
EA ./textures/path_to_the_east_texture.xpm
S ./textures/path_to_the_sprite_texture.xpm
C 241, 145, 255
F 122, 204, 245


11111
10S01
10001
1200111111111111111111111111111111
1000000000000000000000000000000001
1111111111000000000110002020200001
        1011000001110000002000001
        1001000000000002000002001
111111111011000001110000000000001
100000000011000001110111111111111
11110111111111011100000010101
11110111111111011101010010001
11000000110101011100000010001
10002000000000001100000010001
10000000000000001101010010001
1100000111010101111101111000111
11110111 1110101 101111010001
11111111 1111111 111111111111